############
#**..#.....###
#**..#.+..+..#
#**..#+####..#
#**....@.##..#
#**..#.#..+.##
######.##+.+.#
..#.+..+.+.+.#
..#....#.....#
..############