...###
..##.#.####
.##.*###..#
##..+.....#
#...@..#..#
###..###..#
..#..#....#
.##.##.#.##
.#......##
.#.....##
.#######