....#####
....#...#
....#+..#
..###..+###
..#..+..+.#
###.#.###.#.....######
#...#.###.#######..**#
#.+..+.............**#
#####.####.#@####..**#
....#......###..######
....########